3 3 3 3 3 3 3 3 3 3 3 3 3 3 3 3 3 3 3 3
3 1 1 1 1 1 1 2 2 2 1 1 1 1 1 1 1 1 1 3
3 1 1 1 1 1 1 1 1 1 1 1 1 1 1 1 1 1 1 3
3 1 1 1 2 2 1 1 1 1 1 1 1 1 1 1 1 1 1 3
3 1 1 1 1 1 1 1 1 -11 1 1 1 1 1 1 1 1 1 3
3 1 1 1 1 1 1 1 1 1 1 2 1 1 1 1 1 1 1 3
3 1 1 1 2 2 1 1 1 1 1 1 1 1 1 1 1 1 1 3
3 1 1 1 1 1 1 1 1 1 1 1 1 1 1 1 1 1 1 3
3 1 1 1 1 1 1 1 1 2 1 1 1 1 1 1 1 1 1 3
3 1 1 1 1 1 1 1 1 2 1 1 1 1 1 1 1 1 1 3
3 1 1 1 1 2 1 1 1 2 1 1 1 1 1 1 1 1 1 3
3 1 1 1 1 1 2 1 1 2 2 1 101 1 1 1 1 1 1 3
3 1 1 1 1 1 1 1 1 1 1 2 1 1 1 1 1 1 1 3
3 1 1 1 1 1 1 1 1 1 1 2 1 1 1 1 1 1 1 3
3 1 1 1 1 1 1 1 2 2 2 1 1 1 1 2 1 1 1 3
3 1 1 1 1 1 1 1 1 1 2 2 1 1 1 1 1 1 1 3
3 1 1 1 1 1 1 1 1 1 1 1 1 1 1 1 1 1 1 3
3 1 1 1 1 1 1 1 1 1 1 1 1 1 1 1 1 1 1 3
3 1 1 1 1 1 1 1 1 1 1 1 1 1 1 1 1 1 1 3
3 3 3 3 3 3 3 12 12 12 12 3 3 3 3 3 3 3 3 3