3 3 3 3 3 3 3 13 13 13 13 3 3 3 3 3 3 3 3 3
3 1 1 1 1 1 1 2 2 2 1 1 1 1 1 1 1 1 1 3
3 1 1 1 1 1 1 1 1 1 1 1 1 1 1 1 1 1 1 3
11 1 1 1 2 2 1 1 1 1 1 1 1 1 1 1 1 1 1 3
11 1 1 1 1 1 1 1 1 1 1 1 1 1 1 1 1 1 1 3
11 1 1 1 1 1 1 1 1 1 1 2 1 1 1 1 1 1 1 3
11 1 1 1 2 2 1 1 1 1 1 1 1 1 1 1 1 1 1 3
3 1 1 1 1 1 1 1 1 1 1 1 1 1 1 1 1 1 1 3
3 1 1 1 1 1 1 1 1 1 1 1 1 1 1 1 1 1 1 3
3 1 1 1 1 1 1 1 1 1 1 1 1 1 1 1 1 1 1 3
3 1 1 1 1 1 1 1 1 1 1 1 1 1 1 1 1 1 1 3
3 1 1 1 1 1 1 1 1 1 1 1 1 1 1 1 1 1 1 3
3 1 1 1 1 1 1 1 1 1 1 2 1 1 1 1 1 1 1 3
3 1 1 1 1 1 1 1 1 1 1 2 1 1 1 1 1 1 1 3
3 1 1 1 1 1 1 1 2 2 2 1 1 1 1 1 1 1 1 3
3 1 1 1 1 1 1 1 1 1 2 2 1 1 1 1 1 1 1 3
3 1 1 1 1 1 1 1 1 1 1 1 1 1 1 1 1 1 1 3
3 1 1 1 1 1 1 1 1 1 1 1 1 1 1 1 1 1 1 3
3 1 1 1 1 1 1 1 1 1 1 1 1 1 1 1 1 1 1 3
3 3 3 3 3 3 3 3 3 3 3 3 3 3 3 3 3 3 3 3